ILOAT, however, appeared to have the edge over UNAT.	然而，劳工组织行政法庭相对于联合国行政法庭似乎有些优势。	然而,ILOAT似乎比UNAT有优势。
Tell you what. I can give you a ride to Belle's, a diner five miles down.	这样吧，我载你们到5英里外的贝拉餐厅	告诉你吧 我可以载你到Bell餐厅
A/AC.154/363 Letter dated 20 September 2005 from the Permanent Representative of the United States of America to the United Nations addressed to the Chairman of the Committee [A C E F R S]	A/AC.154/363 2005年9月20日美利坚合众国常驻联合国代表给委员会主席的信 [阿、中、英、法、俄、西]	A/AC.154/363 2005年9月20日美利坚合众国常驻联合国代表给委员会主席的信[阿、中、英、法、俄、西]
He's in jail. Maximum security, for Christ's sake.	- 他人在戒备森严的牢里	关进监牢 最高安全度 看在上帝份上
Throughout the nineteenth century and in the first half of the twentieth, as we heard earlier, over 60 million Europeans emigrated, primarily to the Americas — I repeat, 60 million.	在整个十九世纪和二十世纪上半叶，正如我们先前听到的那样，有6 000多万欧洲人移民海外，主要移向美洲——我重复一遍，6 000万。	在整个十九世纪和二十世纪前半叶,正如我们早些时候所听到的那样,6 000万多欧洲人主要移居美洲-我重复6 000万
He liked the dress Mommy bought for me.	他說他喜欢妈妈买给我的裙	喜欢妈妈为我买的衣服
The Panel finds that PIC restored its levels of urea production for financial year 1994/95 to 726,805 metric tons and for the financial year 1995/96 to 839,100 metric tons, which further supports the conclusion that PIC reasonably projected its urea production for the FP claim period.	小组认为，石化公司尿素产量在1994/95财政年度恢复到726,805公吨，在1995/96财政年度恢复到839,100公吨，由此进一步证明了结 论，即，石化公司关于化肥厂索赔期尿素产量的预测是合理的。	小组认定石化公司1994/95财政年度恢复尿素生产水平至726,805公吨,1995/96财政年度恢复生产水平至839,100公吨,这进一步支持石化公司合理预测FP索赔期尿素生产的结论。
Management of the consequences of gender-based violence in reproductive health services.	94. 在生殖保健服务内对基于性别的暴力的后果进行管理。	管理生殖健康服务中基于性别的暴力的后果
• United Nations Mission in Haiti	• 联合国海地特派团	• 联合国海地特派团
Women working in the informal and agricultural sectors were particularly badly off.	在非正规部门和农业部门工作的妇女尤其贫困。	非正式和农业部门工作的妇女尤其差劲。
It is anticipated that, in June, a four-week trial will begin to ascertain the viability of new arrangements for effecting the electronic transmission of authentication data from all four sites.	30．预料在6月，一次为期四个星期的实验将开始确定从所有四个网址以电子方式传送核证数据的新安排是否可行。	预计在6月,为期四周的审判将开始确定新安排从所有四个网站电子传输认证数据的可行性。
Even lke wanted to pose for a photo in front of that huge trophy.	也想在那个巨大的奖杯面前来张合影。	连Lke都想拍照片 站在大奖杯前
However, information from various sources - including NGOs - indicates that these statistics show only the tip of an iceberg.	不过，包括非政府组织在内的各种来源的资料表明，这些统计数字仅仅是冰山一角。	包括非政府组织在内的各种来源的信息显示这些统计只显示冰山一角
Right here.	就这里，快点	站在这里
This paper is fully compatible with the protocol on humanitarian issues recently agreed to, but not yet signed, in Abuja.	该文件完全符合最近在阿布贾商定、但尚未签署的人道主义问题议定书。	这份文件与最近在阿布贾商定但尚未签署的人道主义问题议定书完全兼容。
Four additional cleaners (Local level) will be required to maintain safehouses, which are now occupied for most of the year due to the increase in the number of witnesses.	64. 请求增加4名清洁工（当地雇员）来维持安全住所的清洁，由于证人数目增加，安全住所一年的大部分时间都有人住。	需要增加4名清洁工(当地雇员)维护安全屋,由于证人人数增加,安全屋目前全年大半使用。
That's the point. It stopped.	问题是现在停止了	点点停
(a) An assessment of the funding needs of Parties which are developing countries or countries with economies in transition for the period 2006-2010;	(a) 2006-2010年期间发展中国家或经济转型国家缔约方的资金需求评估；	评估发展中国家或经济转型国家缔约方2006-2010年期间的资金需求;
Car 5	五号车	5号车
Commander, they're calling you to the phone.	主人．您的电话	中校,他们打你电话
14.11 The regular budget resources for the biennium 2004-2005 amount to $9,339,800 and reflect an increase of $984,700 or 11.7 per cent, distributed as follows: (a) $611,200 representing the delayed impact of the six new posts (1 P-5, 2 P-4, 2 P-3 and 1 P-2) established under the Office of the Executive Director, Office of the Deputy Executive Director and the Programme Coordination and Management Unit in the biennium 2002-2003; (b) $170,900 for the establishment of one new P-5 post for the Chief, Evaluation and Oversight Unit of UNEP and one new Local level post to provide programme and administrative support; (c) $138,100 for establishment of one new P-5 post for the Scientific Secretary of the secretariat of the United Nations Scientific Committee on the Effects of Atomic Radiation; and (d) $64,500 for non-post costs, including provisions for consultants, general operating expenses and data-processing equipment.	14.11 2004-2005两年期的经常预算资源为9 339 800美元，增加了984 700美元，增幅为11.7％，分配情况如下：(a) 2002-2003两年期在执行主任办公室、副执行主任办公室及方案协调和管理股新设六个员额（1个P-5，2个P-4，2个P-3和1个P-2）的延迟影响费用611 200美元；(b) 环境规划署评价和监督股新设一个P-5职等股长员额和一个提供方案和行政支持的当地雇员员额的费用170 900美元；(c) 联合国原子辐射影响问题科学委员会（辐射科委）秘书处新设一个P-5职等科学秘书员额的费用138 100美元； (d) 非员额费用64 500美元，包括顾问费、一般业务费用和数据处理设备费用。	14.11 2004-2005两年期经常预算资源为9 339 800美元,增加984 700美元或11.7%,分配如下:(a) 611 200美元是执行主任办公室、副执行主任办公室和方案协调管理股2002-2003两年期设立的6个新员额(1个P-5、2个P-4、2个P-3和1个P-2)延迟影响;(b) 170 900美元用于为环境署评价监督股股长新设1个P-5员额和1个当地雇用员额提供方案和行政支持;(c) 138 100美元为联合国原子辐射科委会秘书处科学秘书新设1个P-5员额;(d) 64 500美元非员额费用,包括顾问费、一般业务费用和数据处理设备费
So you're telling me a giant spider ate Gladys?	你是说一只大蜘蛛吃了葛莱蒂?	这么说你告诉我 一只巨型蜘蛛吃了Gladys
The report deals extensively with the specific difficulties confronted by landlocked developing countries.	该报告对内陆发展中国家所面临的各种具体困难做了广泛的分析。	报告广泛论述内陆发展中国家面临的具体困难。
UNAMA is working closely on this with the Administration.	联阿援助团正与该政权就此密切合作。	联阿援助团正就此与行政当局密切合作。
Expressing concern regarding the unsustainable agendas of the World Bank, IMF and WTO, they urged the United Nations to uphold the principles of the Charter of the United Nations and protect the rights of the poor and oppressed.	他们对世界银行、货币基金组织和世贸组织无法持续的议程表示关注，敦促联合国坚持《联合国宪章》的原则和保障贫穷和受压迫的人的权利。	它们对世界银行、货币基金组织和世贸组织不可持续的议程表示关切,敦促联合国维护《联合国宪章》原则并保护穷人和受压迫者的权利。
We're only waiting for the results to be declared l've spent so much in this election lf l lose this election, l'll have to commit suicide	The famous dance party from Delhi has already arrived... 庆典已准备就绪 all arrangements for the celebration are in place 就等着宣布结果 We're only waiting for the results to be declared	我们只是在等待结果宣布 我在这个选举中花了很多钱 如果我输了这次选举,我不得不自杀
Aah! Do you have a plastic bag?	你有塑料袋吗?	有塑料袋吗
Hence, there was a need to establish a rules-based and truly multilateral monetary system.	因此，有必要建立一种基于规则的真正多边货币制度。	因此,有必要建立基于规则的真正多边货币体系。
This realization demonstrated the need to rethink responses and to develop innovative and creative approaches to address the needs of the most vulnerable across the region.	认识到这一点，就证明必须重新思考对策并拿出创新性和创造性手段，满足整个区域的最脆弱人群的需求。	这一点证明需要重新思考对策并开发创新和创举方法,解决全区域最弱势群体的需要。
Absolutely. Along with my crew, including Ulysses,	当然, 和我的队员们一起,包括尤利西斯	完全正确 和我的机组成员 包括尤利西斯
For the text, see paragraph … below.	案文见下文第……段。	文本见下文第.段
Recalling its resolutions 56/196 of 21 December 2001 and 57/259 of 20 December 2002 and other resolutions relating to the United Nations Convention to Combat Desertification in Those Countries Experiencing Serious Drought and/or Desertification, Particularly in Africa,	回顾其2001年12月21日第56/196号决议和2002年12月20日第57/259号决议，以及与《联合国关于在发生严重干旱和/或荒漠化的国家特别是在非洲防治荒漠化的公约》 有关的其他决议，	回顾其2001年12月21日第56/196号和2002年12月20日第57/259号决议以及与《联合国关于在发生严重干旱和/或荒漠化的国家特别是在非洲防治荒漠化的公约》
The General Committee, by 11 votes to 3, with 4 abstentions, decided to recommend that this item be considered directly in plenary meeting.	总务委员会以11票对3票、4票弃权决定建议直接在全体委员会审议该项目。	总务委员会以11票对3票、4票弃权决定建议在全体会议上直接审议该项目。
You're gonna lock me up?	你要把我关起来?	你要锁我?
You'll find Goki outside.	豪鬼不会有事的	外头会找到高基
My Special Representative, regional leaders, Somali religious leaders and elders and the rest of the international community have similarly encouraged those groups to seize the moment and join in the international effort in pursuit of bringing peace to Somalia.	我的特别代表、区域领导人、索马里宗教领袖和长老以及国际社会其他各方都鼓励这些团体抓住时机，加入国际努力，力争在索马里实现和平。	我的特别代表、区域领导人、索马里宗教领袖和长老以及国际社会其他成员同样鼓励这些团体抓住时机并加入国际努力,为索马里带来和平。
Notification of disagreement under article 1(4) of the Agreement: Japan (12 December 2002)1	加入：尼加拉瓜(2002年12月12日) 4	协议第1(4)条下分歧通知:日本(2002年12月12日)
A solution to the Iranian nuclear issue would contribute to global non-proliferation efforts and to realizing the objective of a Middle East free from weapons of mass destruction, including their means of delivery.	解决伊朗核问题将有助于全球防扩散努力，有助于实现中东消除大规模毁灭性武器包括其运载工具的目标。	解决伊朗核问题将有助于全球不扩散努力和实现中东无大规模毁灭性武器包括其运载工具的目标。
On 10 September 2001 a petition for the early termination of supervision was submitted on behalf of the nine former prisoners still subject to parole conditions.	2001年9月10日，为仍处于假释期的9名前囚犯提交了提早结束监管的申请书。	2001年9月10日,代表九名仍受假释条件保护的前囚犯提交提前终止监督请求
The health data may be joined with data from a database containing genetic data and a database containing genealogical data.	健康资料可与遗传资料数据库和遗传资料数据库的资料合并。	健康数据可与含有遗传数据的数据库和含有基因数据的数据库相联
They have regarded the collective assurances provided so far, including those contained in Security Council resolutions 255 of 1968 and 984 of 1995, as overburdened with conditions and caveats and have called for, instead, legally binding assurances.	它们认为迄今为止所提供的集体保证，包括安全理事会1968年第255号决议和1995年第984号决议中包含的保证，附带了太多的条件和警告，要求有法律约束力的保证。	他们认为迄今提供的集体保证,包括安全理事会1968年第255号决议和1995年第984号决议所载保证,因条件和警告而负担过重,并代之以要求有法律约束力保证。
We call Shenzhou 7 "Sheven".	神舟七号，就叫「神七」	沈州7号Sheven
On this questionnaire, see the seventh report (A/CN.4/526), para.	关于此问卷，请见第七次报告，A/CN.4/526，第17段。	关于本调查表,见第七次报告(A/CN.4/526),第2段
He set us up, Lucy. The man set us up.	露西，他耍我们，他骗了我们	他陷害我们 露西 人陷害我们
The following is the draft provisional agenda for the thirty-fifth session of the Committee:	628. 委员会第三十五届会议临时议程草案如下：	以下是委员会第三十五届会议临时议程草案:
Would you ask somebody to lynch you and tell you where to go and how to look, then refuse to pay you?	你会让别人把你捆起来 牵着走 Would you ask somebody to lynch you 告诉你做什么 怎么做 却不付你一文钱吗 and tell you where to go and how to look, then refuse to pay you?	求人解析你 并告诉你去哪儿和如何寻找, 并拒绝支付你
- No, it's not a mistrial!	不 这不会是未决审判	不,这不是误判
Please don't choose based on photos	等一下　請不要再光用相片來決定了	请不要基于照片选择
Adopted at the 52nd plenary meeting, on 19 November 2002, without a vote, on the recommendation of the Committee (A/57/571, para. 7)The draft resolution recommended in the report was sponsored in the Committee by: Bangladesh, China, Egypt, Gambia, India, Indonesia, Jordan, Kenya, Mali, Mexico, Morocco, Nigeria, Pakistan, Thailand, Tunisia, Uganda and Zimbabwe.	2002年11月19日第52次全体会议根据委员会的建议（A/57/571，第7段）报告中建议的决议草案由下列提案国在委员会提出：孟加拉国、中国、埃及、冈比亚、印度、印度尼西亚、约旦、肯尼亚、马里、墨西哥、摩洛哥、尼日利亚、巴基斯坦、泰国、突尼斯、乌干达和津巴布韦。 未经表决而通过	2002年11月19日第52次全体会议根据委员会的建议(A/57/571,第7段)报告中建议的决议草案由下列提案国在委员会提出:孟加拉国、中国、埃及、冈比亚、印度、印度尼西亚、约旦、肯尼亚、马里、墨西哥、摩洛哥、尼日利亚、巴基斯坦、泰国、突尼斯、乌干达和津巴布韦
Tell me, is this...the better way?	告诉我 这样更好吗?	告诉我,这是... 更好的方法吗?
(a) Progress on the implementation of decision 1/CP.10;	第1/CP.10号决定的执行进展情况； 与最不发达国家有关的事项。	执行第1/CP.10号决定的进展;
As a result, the proportion of women in the Congress of the Union rose significantly.	469. 因此，女性在议会中所占比例大大增加了。	结果,妇女在联盟大会中的比例大幅提高。
7) Reference to international instruments - By referencing several international instruments on civil and political rights, the Collective was better able to influence the government.	7) 参考国际文书——通过参考一些有关公民权利和政治权利的国际文书，魁北克集体能够更好地影响政府。	7) 参考国际文书-通过引用数项公民权利和政治权利国际文书,集体能够更好地影响政府
More than this world gives	还得那么少	多世界提供
Do you think that we would ever go to jail if we were caught?	你认为 我们会永远去坐牢 如果我们抓住了？	万一被抓了会进监狱吗
Reaffirming the Universal Declaration of Human Rights,Resolution 217 A (III). the International Covenant on Economic, Social and Cultural Rights,See resolution 2200 A (XXI), annex. the International Convention on the Elimination of All Forms of Racial Discrimination,Resolution 2106 A (XX), annex. the Convention on the Elimination of All Forms of Discrimination against WomenResolution 34/180, annex. and the Convention on the Rights of the Child,Resolution 44/25, annex.	重申《世界人权宣言》、第217 A(III)号决议。 《经济、社会、文化权利国际盟约》、见第2200 A(XXI)号决议，附件。 《消除一切形式种族歧视国际公约》、第2106 A(XX)号决议，附件。 《消除对妇女一切形式歧视公约》第34/180号决议，附件。 和《儿童权利公约》，第44/25号决议，附件。	重申《世界人权宣言》、第217 A(III)号决议。 《经济、社会、文化权利国际公约》、见第2200 A(XXI)号决议,附件。《消除一切形式种族歧视国际公约》、第2106 A(XX)号决议,附件。《消除对妇女一切形式歧视公约》第34/180号决议,附件。 和《儿童权利公约》,第44/25号决议,附件。
- Some paternal wisdom. How about that?	- 来点父辈的智慧，怎么样？	父权智慧 怎么样
And then again, had I turned off, say at 90 degrees, to try and avoid them, you're still turning across quite a number of them.	其次,要是我拐弯,比方说 转90度,以试图避开他们, 你仍会穿过许多的它们(轰炸机)	并再次,如果我关机,说90度, 试图避免它们, 你仍然翻遍相当多次
Remedies - review provisions under the Model Law, chapter VI (A/CN.9/WG.I/WP.64, paras.	A. 救济 - 示范法第六章下的审查规定（A/CN.9/WG.I/WP.64，第5-9段）	补救-审查《示范法》第六章的规定(A/CN.9/WG.I/WP.64,第12-14段)
Finally, the need to finance disarmament, demobilization and reintegration programmes through the assessed budget for peacekeeping (recommendation 8) remains an issue of concern.	63. 最后，通过维和预算为解除武装、复员和重返社会方案筹集资金（建议8）仍然是一个关切的问题。	最后,需要通过维和分摊预算为解除武装、复员和重返社会方案提供资金(建议8),这仍然是一个令人关切的问题。
The relationship between epidemiological and demographic transition is reciprocal and has implications for the health conditions of the population and on the extent of the demand for health care.	17. 流行病与人口结构的转型之间的关系是彼此对应的，影响到人口健康情况和保健方面的需求。	流行病学与人口结构转换之间的关系是对等的,对人口的健康状况和对保健需求范围有影响。
- But here, it's different?	但那是不一樣的 不一樣？	- 但这里不同?
There is also a Directorate for Occupational Hygiene, Health and Safety in the Ministry of Justice and Labour.	此外，司法和劳动部专门设立了职业卫生、健康和安全局。	司法和劳动部还设有职业卫生、卫生与安全局。
My delegation voted in favour of the present resolution, convinced that there must be convergence of all international efforts if stability is to be achieved in Iraq for the benefit of its people, who have suffered greatly in the past and who continue to suffer from daily acts of violence, which have repercussions on the stability of the entire region.	我国代表团对本决议投了赞成票，我们相信，如果要为伊拉克人民的利益而实现该国的稳定，必须一致作出所有国际努力。 这些人民过去受尽苦难并继续每天遭遇暴力行为，对整个区域的稳定造成了影响。	我国代表团对本决议投了赞成票,确信所有国际努力必须齐头并进,伊拉克才能实现稳定,造福伊拉克人民,他们过去深受苦难,每天继续遭受暴力行为之害,这对整个区域的稳定产生影响。
Hit him for me.	给我打得连他妈妈都不认识他	替我打他
You've been expelled!	可是人家不要你，把你赶了出来	你被开除了
Rule relating to article 90 (Competing requests)	关于第九十条(竞合请求)的规则	与第九十条(竞合请求)有关的规则
In this connection, has the work of the Truth and Reconciliation Commission integrated a gender perspective?	在这方面，请说明真相与和解委员会的工作中是否纳入了两性平等观点。	在这方面,真相与和解委员会的工作是否纳入了性别观点?
Agriculture is a central element in the current negotiations.	75. 农业是目前谈判中的一项核心要素。	农业是当前谈判的中心内容
(Chuckles) Uh... okay. Uh, you're here. That means that the party is starting.	好 你来了 那派对就正式开始了	好,你来了 表示派对开始
In his agenda for further change, the Secretary-General noted that the General Service staff are an extraordinary source of skill and expertise and emphasized the importance of creating more opportunities for them.	秘书长在其进一步改革纲领中指出，一般事务人员是本组织技能和专门知识的特殊来源，并强调为他们创造更多机会的重要性。	秘书长在其进一步改革议程中指出,一般事务工作人员是技能和专门知识的异常来源,并强调必须为他们创造更多机会。
Reminders seemed to help elicit many of these responses.	提醒函似乎有助于促使其中许多国家作出答复。	提醒似乎帮助获取其中许多响应
(b) Ensure that - as promised by the President - the necessary earmarked budgets are provided to the special unit created to investigate these crimes not only to deal with the current cases but also with all the cases waiting for investigation;	系统收集一切对儿童的暴力和虐待、特别是法外处死的数据和信息； 如总统所承诺的那样，确保向为调查这些犯罪而设立的特别小组提供必要的特定拨款，不仅处理目前的案件，也处理一切等待调查的案件； 向受害者家庭提供适当支持和赔偿； 限制武器，并确保只有在政府严格控制下才可出售； 既然大多数暴力行为据说产生在Tegucigalpa 和 San Pedro Sula最穷困的城区，因此应处理这些暴力行为的根本原因，包括贫困和社会边缘化； 与媒体合作采取措施，教育公众在处理少年黑帮问题的战略中反对使用暴力和其他非法手段； 确保设立和/或(如果已经存在)加强独立控制和监督警方活动的机制。	保证----如总统允诺----向为调查这些罪行而设的特别单位提供必要的专用预算,这不仅是为了处理当前案件,而且也是为了处理所有等待调查的案件;
The endpoint of such a process may be the hitherto unimaginable use of weapons of mass destruction.	这种过程的极点可能就是迄今难以想象的使用大规模杀伤性武器。	这一进程的终点可能是迄今无法想象的大规模毁灭性武器使用问题。
The regional commissions, with the assistance of the secretariat of the Commission on Sustainable Development, organized regional meetings and ad hoc sessions on water, sanitation and human settlements as contributions to the twelfth session of the Commission.	区域委员会在可持续发展委员会秘书处的协助下，举办了几个关于水、卫生和人类住区的区域会议，作为对第十二届委员会会议的一项贡献。	各区域委员会在可持续发展委员会秘书处的协助下,组织了关于水、环境卫生和人类住区的区域会议和特别会议,为可持续发展委员会第十二届会议作出贡献。
Suely de Oliveira - Sub-Department for Institutional Articulation (Subsecretária de Relações Institucionais)	Suely de Oliveira - 机构磋商分部	Suely de Olivera分局机构划分
- You were the spider in mywindow.	也许是因为你先对我好的	- 你是我窗外的蜘蛛
His delegation regretted the absence of a system for accurate data collection, analysis and reporting on consultants and contractors and supported the recommendations in the report of the Joint Inspection Unit (JIU) on the use of consultants in the United Nations (A/55/59), especially those recommendations that were also supported by CPC and ACABQ.	阿尔及利亚代表团对缺少一种收集、分析和汇报有关顾问及承包商的精确资料的体制表示遗憾，并支持联合检查组（联检组）关于联合国使用顾问情况的报告（A/55/59）中的建议，特别那些也得到方案协调会和行预咨委支持的建议。	美国代表团感到遗憾的是,没有一个系统准确收集、分析和报告顾问和承包商,支持联合检查组报告(A/55/59)中关于联合国使用顾问的建议,特别是那些也得到方案协调会和行预咨委会支持的建议。
Unmarried women are discouraged by cultural taboos to visit gynaecologists.	因文化禁忌，未婚妇女不愿看妇产科医生。	未婚妇女受文化禁忌阻扰看妇科医生
- What would you have me do? Draco.	你要我怎么做 德拉科	德拉科
With regard to overall coordination and consultation mechanisms, high-level visits take place between UNHCR and the Council secretariat on a regular basis.	29. 在全面协调和协商机制方面，难民专员办事处和欧洲委员会秘书处彼此经常有高级别互访。	关于总体协调和协商机制,难民署和理事会秘书处定期进行高级别访问。
Consequently, the Commission decided to publish a sequel to this publication.	因此，委员会决定就该出版物出版一份续集。	因此,委员会决定出版该出版物的续集
- Who says I'm lonely?	谁说我孤独了 Who says I'm lonely?	- 谁说我孤独
Yeah, it's "Penny already eats our food.	嗯 现在是"佩妮蹭我们吃的 Yeah, it's "Penny already eats our food.	对 潘尼已经吃下我们的食物
Well, since time is of the essence, perhaps I'll just go ahead and add a plus-three to the Prophet's invitation.	我还是直接在先知的邀请函上 增加三个名额好了	时间至关紧要,也许我先去预言者邀请书加加3
Ladies and gentlemen, I want to assure you that no media pressure will influence my objective judgment.	女士们，先生们，我想向你保证 没有媒体的压力会影响我的客观判断。	女士们先生们,我想向你们保证 媒体压力不会影响我客观判断
The Lebanese military authorities contacted the Palestinians to ensure safe passage for the team to enter the valley.	黎巴嫩军事当局与巴勒斯坦方面进行了联系，以保障小组安全进入山谷。	黎巴嫩军事当局与巴勒斯坦人联系,以确保安全通道小组进入河谷
cool. cool. wecannotlethim even wecannotlethim even suspect, even at tribal, because	我们不能让他起疑 即便是在部落会议上	酷酷 我们甚至不能让他怀疑 甚至在部落里
On 26 January, in Lunyenya, south of Bukavu, a woman over the age of 70 was abducted and then raped by two FARDC members, according to a note from the OHCHR field office dated 30 January 2006.	人权高专办办事处2006年1月30日的说明中报告，2006年1月26日在布卡武南部的Lunyenya，一名70多岁的妇女遭到绑架，被刚果（金）武装部队两名士兵强奸。	1月26日,在布卡武以南Lunyenya,一名70岁以上的妇女被两名刚果(金)武装力量成员绑架并强奸,据人权高专办外地办事处2006年1月30日的注解
Ms. Gabr said that it was important to provide adequate funding for basic social services, especially education.	2．Gabr女士说，为基本的社会服务，特别是教育，提供充足的资金是非常重要的。	Gabr女士说,必须为基本社会服务,特别是教育提供充足资金。
They could have asked the Federal Court for leave to apply for judicial review of the PRRA decision and, at the same time, could have requested a stay of the removal order pending the outcome.	她们本可以请求联邦法院批准其申请对遣返前风险评估决定进行司法审查，并同时可以请求在等候结果期间暂缓执行驱逐令。	他们本可请求联邦法院允许申请对递解前风险评估决定进行司法复议,并同时可请求暂缓执行递解令等待结果
She's going in the water. OK.	- 它要进水了，好了	水里
Well, Father is a little worried about you.	父亲有一点为你担心	父王有点担心你
A massive logistics operation was soon established, however, with military assets from over 17 countries, which enabled local authorities and humanitarian organizations to assist stricken communities.	不过，由于17个以上的国家提供军事器材支助，很快开展了规模庞大的后勤行动，使地方当局和人道主义组织能够向受灾社区提供援助。	不久将建立大规模后勤业务,17多个国家提供军事资产,使地方当局和人道主义组织能够帮助受灾社区。
Enough. Nothing to see.	好了好了，别围着	够了 没什么好看
It has at its disposal the instruments to manage political conflicts and the underlying development problems that nurture hatred and despair.	联合国有各种文书可供用来处理政治冲突以及助长仇恨与失望的潜在发展问题。	它拥有工具管理政治冲突以及滋生仇恨和绝望的潜在发展问题。
I would also like to apologize... to all my working partners.	另外，我要郑重地 向所有的工作伙伴致歉	我还要向所有工作伙伴表示歉意
We are particularly pleased with the Council's cooperation with and support for regional organizations to resolve conflicts, especially in Africa.	我们特别感到满意的是，安全理事会与区域组织进行合作并为其提供支持以解决冲突，特别是非洲的冲突。	令我们特别高兴的是,安理会与区域组织合作并支持区域组织解决冲突,特别是在非洲解决冲突。
New donor commitments on ODA are welcome, though the targets are several years in the future.	欢迎对官方发展援助作出新的捐助承诺，不过这方面的指标是在今后的若干年中。	新的捐助方对官发援的承诺值得欢迎,尽管目标在未来几年内实现。
Even my friends think I'm sleeping with someone who never heard of	我的朋友竟然以为 我和一个我没听过的人上床	连我朋友都认为我和 从未听说过的人上床
